1111111111111111111111111111111
1XCXCXCXCXC00CC0CC0000C0PC0C0E1
1XCXCXCXCXC00CC0CC0000C00C0C011
1XCXCXCXCXC00CC0110000C00C0C011
1XCXCXCXCXC00CC0110000C00C0C011
1XCXCXCXCXC00CC0110000C00C0C011
1XCXCXCXCXC00CC0110000C00C0C011
1XCXCXCXCXC00CC0110000C00C0C011
1XCXCXCXCXC00CC0110000C00C0C011
1XCXCXCXCXC00CC0110000C00C0C011
1XCXCXCXCXC00CC0CC0000C00C0C011
1XCXCXCXCXC00CC0CC0000C00C0C011
1111111111111111111111111111111