1111111111111
1000000E001C1
1000011111101
10P0000000001
1111111111111