1111111111111
100100CCC00C1
1000011111CC1
100011E00CCC1
10101110001C1
101P11000C0C1
1111111111111